NO febwjfkw
SO fbewjkfbew
EA      vhejkve


WE vre


F regbjkre
C grekjgbre

11111111111111111