NO grbjkgre
SO rebjkgre
EA nrekgre




WE brtnklbrt
F brtnbklrt



C trnkltr


1111111111111111111blabalbal1111111111111111111111
111111111111111111111111111111
111111111111111111111111111111
111111111111111111111111111111
111111111111111111111111111111
111111111111111111111111111111