NO grbjkgre
SO rebjkgre


EA nrekgre
WE vgjrebkre
F 200,0,23
C 23,34,2


11111111111111111111111111
1111111111111111111111111111111111111111111111111111
11111111111111111111111111
11111111111111111111111111
