NO imgs/test.xpm
SO imgs/test.xpm


EA imgs/test.xpm
WE imgs/test.xpm
F 200,0,23
C 23,34,2


11         111111111111111111111111
1111111111111111111111111111111111111111111111111111
110000000000        00000000000111111111111111111111111
11111111111111111100000000000011111111
1111110111111100000000000000001111111111111
111111111111111111111111111
101111101111111100111111111
1111111111111100N0011111111
1111111111111110000111111111
111111111111111111111111111
