NO imgs/test.xpm
SO imgs/test.xpm


EA imgs/test.xpm
EA imgs/test.xpm
F 200,0,23
C 23,34,2


111111111111111111111111111111111111
100000000000000000000000000000000011
100000000000000000000000000000000011
1111111111110000000000000000000000011
100000000000000000000000000000000011
10000000000000000000N100000000000011
100000000000000000000000000000000011
100000000000000000000000001111111111
100000000000000000000000000000000011
100000000000000000000000000000000011
11         111111111111111111111111
